5 9

#################
# . . . . . . . #
# $ . @ . . . . #
# . . . . . . . #
#################
