15 15
#############################
#############################
#############################
#############################
#############################
#############################
# . . . . . . . . . . . . . #
# $ . . . . . . . . . . @ . #
# . . . . . . . . . . . . . #
#############################
#############################
#############################
#############################
#############################