15 15
# # # # # # # # # # # # # # # 
# # # # # # # # # # # # # # #
# # # # # # # # # # # # # # #
# # # # # # # # # # # # # # #
# # # # # # # # # # # # # # #
# # # # # # # # # # # # # # #
# . . . . . . . . . . . . . #
# $ . . . . . . . . . . @ . #
# . . . . . . . . . . . . . #
# # # # # # # # # # # # # # #
# # # # # # # # # # # # # # #
# # # # # # # # # # # # # # #
# # # # # # # # # # # # # # #
# # # # # # # # # # # # # # #