5 9
# # # # # # # # #
# . . . . . . . #
# $ . @ . . . . #
# . . . . . . . #
# # # # # # # # #