15 15
# . . . . . . . . . . . . . #
# . # # # # # # # # # # # . #
# . . . . . . . . . . . # . #
# # # # # # # # # # # . # . #
# . . . # # . # # # # . # . #
# . # . # # . # # # # . # . #
# . # . . . . . . . # . # . #
# . # # # # # # # . # . # . #
# . . . . . . . # . . . # . #
# # # # # # # . # # # # # . #
# # . . . . # . . . # @ # . #
# # . # # . # # # . # . # . #
# # . # # . # # # . # . # . #
# $ . % # % . % . . # . . . #
# # # # # # # # # # # # # # #