10 10
# . . . # # # # # #
# # # . . # # . . .
# . . . . . . . # .
# . . . . . . . . #
# . % . . # # . . #
. . . # . # . . . .
. . . # . # # # . .
. . # # % # # . . .
# $ # # . # @ . . #
# . . . . # . . # #