10 10
# @ . # . . . . . .
# . . # . . . % % .
# . . # . . . . . .
# . . . . % . . . .
# # # # # # # . # #
# . . # . . . . . .
# . . # . # # # # #
# . . # . . . . . .
# $ . . % . # . . .
# . . . . . # . . .