20 20
# . . . . . . . . . . . . . # # # # # #
# . # # # # # # # # # # # . # # # # $ #
# . . . . . . . . . . . # . # # # # . #
# # # # # # # # # # # . # . # # # # . #
# . . . # # . # # # # . # . # # # # . #
# . # . # # . # # # # . # % # # # # . #
# . # . . . . . . . # . # . # # # # . #
# . # # # # # # # . # . # . # . . . . #
# . . . . . . . # . . . # . # . # # . #
# # # # # # # . # # # # # . # . # # # #
# # . . . . # . . . # @ # . # . . . # #
# # . # # . # # # . # . # . # # # . # #
# # . # # . # # # . # . # . # # # . # #
# % . % # % . % . . # . . . # # # % # #
# # . # # # # # # # # # # # # # # . # #
# # . # . . . . # # # # # . % . # . # #
# # . # . # # . # # # # # . # . # . # #
# # . . % # # . # . . . # . # . # . # #
# # # # # # # . . . # . . . # . . . # #
# # # # # # # # # # # # # # # # # # # #