15 15
#############################
# % . % . % . % . % . % . % #
# . . . . . . . . . . . . . #
# % . % . % . % . % . % . % #
# . . . . . . . . . . . . . #
# % . % . % . % . % . % . % #
# . . . . . . . . . . . . . #
# . . % . % . % . . . . @ . #
# % . % . % . % . % . % . % #
# . . . . . . . . . . . . . #
# % . % . % . % . % . % . % #
# . . . . . . . . . . . . . #
# % . % . % . % . % . % . % #
# $ . . . . . . . . . . . . #
#############################