15 15
# # # # # # # # # # # # # # #
# % . % . % . % . % . % . % #
# . . . . . . . . . . . . . #
# % . % . % . % . % . % . % #
# . . . . . . . . . . . . . #
# % . % . % . % . % . % . % #
# . . . . . . . . . . . . . #
# . . % . % . % . . . . @ . #
# % . % . % . % . % . % . % #
# . . . . . . . . . . . . . #
# % . % . % . % . % . % . % #
# . . . . . . . . . . . . . #
# % . % . % . % . % . % . % #
# $ . . . . . . . . . . . . #
# # # # # # # # # # # # # # #